111111111111111111111111111111111111111111111111111111111111111111111111111111111111111111111111
1E000C0000C0000C000000C0000C0000C000000C0000C0000C000000C0000C0000C000000C0000C0000C000000000011
10000000C0000000000000C00000000000000000C00000000000000000C00000000000000000C00000000000C0000001
100000C0000C0000C000000C0000C0000C000000C0000C0000C000000C0000C0000C000000C0000C0000C000000C0011
100000000000000000000000000000000000000000000000000000000000000000000000000000000000000000P00001
100011111111000111111111110001111111111100011111111111000111111111110001111111111100011111111111
10000000C0000000000000C00000000000000000C00000000000000000C00000000000000000C0000000000000000001
1000C0000C0000C000000C0000C0000C000000C0000C0000C000000C0000C0000C000000C0000C0000C0000C00000111
100000000000000000000000000000000000000000000000000000000000000000000000000000000000000000000001
1000C0000C0000C000000C0000C0000C000000C0000C0000C000000C0000C0000C000000C0000C0000C0000C00000111
100000000000000000000000000000000000000000000000000000000000000000000000000000000000000000000001
111111111111111111111111111111111111111111111111111111111111111111111111111111111111111111111111