1111011111111
10010C0000001
1000011111001
1P0011E000000
1111000000001
1C00000000001
1000001111101
1000000000001
1110111111111