1111111111
1P00C00C01
1011111111
10CE000C01
1011101111
10C01E0C01
1111111111