1111111
1P0C001
100C001
1000E01
1111111