1111111111
1P10C00C01
1111111111
10C0000C01
1011101101
10C0E00C01
1111111111