1111111111111111111111111111111
1P000000000C0000000000000000001
1000011111111100000111111110001
1C000000000000C00000000000C0001
1000111111111000000111111110001
1C00000000000000000000000000001
100001111111110C000011111111001
1C0000000000000C00000000000C001
1000111111111100000111111110001
1C0000000000000000000000000E001
1111111111111111111111111111111
