1111111111111111111
1P000000000000C0001
1011111111111111101
1010000C00C0000C101
1010111111111110101
1010100000000010101
1010101111111010101
10101010E0C01010101
1010101111101010101
1010100000001010101
1010111111111010101
101000000C000010101
1011111111111110101
1000000C00000000101
1111111111111111111