1111111111111
1P00000000001
1111111110101
1C0000000C101
1011111110101
1010E00000101
1010111110101
1010C00010101
1010000C10C01
1111111111111