1111111111111
1P00000000EC1
100001L0C0111
1000011111111
1111111111111
