1111111
1P00001
10C1C01
1000E01
1111111
