1111111111111111
1P00000000000C11
1011110111110101
1000000100000001
1111011110111101
1C00000000000001
1110111011110111
10000000000000E1
1110111011110111
1000000000000001
1111011110111111
1C00000000000001
1111011110111101
1000000000000001
1111011110111101
1C00000000000C01
1111111111111111
