11111111111111
1P0000C0000001
101111111111C1
10C000000000E1
111110111111C1
1C00000000C001
11111111111111